NO ./textures/purplestone.xpm
SO ./textures/purplestone.xpm
WE ./textures/purplestone.xpm
EA ./textures/purplestone.xpm

F 220,100,0
C 225,30,0

1111111
10000S1
1000001
1010001
1000001
1111111
