NO ./textures/skull.xpm
SO ./textures/smile.xpm
WE ./textures/siluet.xpm
EA ./textures/hand_skull.xpm

F 128,0,32
C 135,206,235

1111111111111111
1000000000000001
1E00000001110001
1000010000000001
1111111111111111
