NO ./imgs/75aa2c5f6ea1e84ecd195af9ddcd6216--hand-painted-textures-texture-cartoon.jpg
SO ./imgs/147637101.jpg
WE ./imgs/240_F_114739098_K6YMavKJf6T2H9tdl3JCPckdctHrcAIm.jpg
EA ./imgs/hacker-sombra-overwatch-video-game-wallpaper-2800x2100_28.jpg

F 220,100,0
C 225,30,0

        1111111111111111111111111
        1000000000110000000000001
        1011000001110000000000001
        1001000000000000000000001
111111111011000001110000000000001
100000000011000001110111111111111
11110111111111011100000010001
11110111111111011101010010001
11000000110101011100000010001
10000000000000001100000010001
10000000000000001101011010001
11000001110101011101011010N0111
11110111 1110101 100011000001
11111111 1111111 111111111111