NO ./textures/skull.xpm
SO ./textures/smile.xpm
WE ./textures/siluet.xpm
EA ./textures/hand_skull.xpm

F 128,0,32
C 135,206,235

11111111111111111111
1001000000000000111
11111000000000000001
1E000000011100001111
1000010000000001
1111111111111111
