NO ./textures/skull.xpm
SO ./textures/smile.xpm
WE ./textures/siluet.xpm
EA ./textures/hand_skull.xpm

F 128,0,32
C 135,206,235

        1111111111111111111111111
        1W00000000110000000000001
        1011000001110000000000001
        1001000000000000000000001
111111111011000001110000000000001
100000000011000001110111110111111
11110111111111011100000010001
11110111111111011101010010001
11000000110101011100000000001
10000000000000001100000000001
10000000000000001101010010001
11000001110101011111011110001
11110111 1110101 101111110001
11111111 1111111 111111111111
