NO ./textures/purplestone.xpm
WE ./textures/wood.xpm
SO ./textures/bluestone.xpm
EA ./textures/redbrick.xpm

C 200,200,200
F 100,100,100

111111111111111111111111
11111000N0011100000000001
111100000011100111111111
111110000011100000000001
111100000001000000000001
111000000001000000000001
111000000001100000000001
101000000000100000000001
101000000000110000000001
100000000000000000000001
111111111111111111111111
