NO ./textures/purplestone.xpm
WE ./textures/wood.xpm
SO ./textures/bluestone.xpm
EA ./textures/redbrick.xpm

C 200,200,200
F 100,100,100

111111111111111111111111111111111111111111111
1000000N0011100000000000000000000000000000001
100000000011100111111111111111111111111111111
100000000011100000000000000000000000000000001
111000000001000000000000000000000000000000001
111000000001000000000000000000000000000000001
111000000001100000000000000000000000000000001
101000000000100000000000000000000000000000001
101000000000110000000000000000000000000000001
100000000000000000000000000000000000000000001
100000000000000000000000000000000000000000001
100000000000000000000000000000000000000000001
100000000000000000000000000000000000000000001
100000000000000000000000000000000000000000001
100000000000000000000000000000000000000000001
100000000000000000000000000000000000000000001
100000000000000000000000000000000000000000001
100000000000000000000000000000000000000000001
100000000000000000000000000000000000000000001
111111111111111111111111111111111111111111111
