NO ./textures/purplestone.xpm
WE ./textures/wood.xpm
SO ./textures/bluestone.xpm
EA ./textures/redbrick.xpm

C 200,200,200
F 100,100,100

111111111111111111111111
1000000N0011100000000001
100000000011100111111111
100000000011100000000001
1110000000010000000000011111111111111111111111111111111111111111111111
1110000000010000000000000000000000000000000000000000000000000000000001
1110000000011000000000011111111111111111111111111111111111111111111111
101000000000100000000001
101000000000110000000001
100000000000000000000001
111111111111111111111111
