NO ./textures/smile.xpm
WE ./textures/siluet.xpm
SO ./textures/skull.xpm
EA ./textures/hand_skull.xpm

F 220,100,0
C 225,30,0

111111111111111111111111111111111111111111
10000W000000000000000000000000000000000001
100000000000000000000000000000000000000001
10000000000000000000000000111111000000000111111
11111000111111111101100011111111110000000000001
10000000000000001101100011111111100000000000001
10000000000000001101000001111111100000000111101
100000000000000011010000011111111000000001  101
110000001111110111110111011111111110111111  101
110000000000110110011000000000000000111111  101
110011100110110111011000000000000000111111  101
10000100001000000001100000000000000000000111101
10000100001000000001100000000000000000000000001
10001110001000000001100000000000000000000000001
10001110000000000001100000000000000000000111111
100000000000000000000000000000000111111111
111111111111111111111111111111111111111111
