NO ./textures/smile.xpm
WE ./textures/siluet.xpm
SO ./textures/skull.xpm
EA ./textures/hand_skull.xpm

F 220,100,0
C 225,30,0

    111111111111111111111111111111111111111111
    10000W000000111000000000001111110000000001
    100000000000111000000000001111110000000001
    100000000000111000000000001111110000000001
    111110011111111111011000111111111100011111
    100000010000000011011000111111111000000001
    100000010000000011011000111111111000000001
    100000010000000011011101111111111000000001
11111011111111011111011101111111111011111111
11000000000011111001100000000000011111111
11001110011011111101100000000000011111111
10000100001000000001100000000000011111111
10000100001000000001100000000000011111111
1000111000100000000110000000000001111
1000111000100000000110000000000001111
1000000000100000000000000000000001111
1111111111111111111111111111111111111
